3333333333333333333333333333333333333333333333
3333333333333333333333333333333333333333333333
3333333333333333333333333333333333333333333333
3333333333333333333333333333333333333333333333
3333333333333333333333333333333333333333333333
3333333333333333333333333333333333333333333333
3333333333333333333333333333333333333333333333
3333333333333333333333333333333333333333333333
3333333333333333333333333333333333333333333333
3333333333333333333333333333333333333333333333
3333333333333333333333333333333333333333333333
3333333333333333333333333333333333333333333333
3333333333333333333333333333333333333333333333
3333333333333333333333333333333333333333333333
3333333333333333333333333333333333333333333333
3333333333333333333333333333333333333333333333
3333333333333333333333333333333333333333333333
3333333333333333333333333333333333333333333333
3333333333333333330033333333333333333300220000
3333300033333333330033333333333333333300220000
0000000000000000000000000000000000000000000000