333333333333333333333333333333333333333333333333333333333333333
333333333333333333333333333333333333333333333333333333333333333
333333333333333333333333333333333333333333333333333333333333333
333333333333333333333333333333333333333333333333333333333333333
333333333333333333333333333333333333333333333333333333333333333
333333333333333333333333333333333333333333333333333333333333333
333333333333333333333333333333333333333333333333333333333333333
333333333333333333333333333333333333333333333333333333333333333
333333333333333333333333333333333333333333333333333333333333333
333333333333333333333333333333333333333333333333333333333333333
333333333333333333333333333333333333333333333333333333333333333
333333333333333333333333333333333333333333333333333333333333333
333333333333333333333333333333333333333333333333333333333333333
333333333333333333333333333333333333333333333333333333333333333
333333333333333333333333333333333333333333333333333333333333333
333333333333333333333333333333333333333333333333333333333333333
333333333333333333333333333333333333333333333333000333333333333
333333333333333333333333333333333333333333333333333333333333333
333333333333333333330033333333330333333300000033333333333333330
333333300033333333330033333333330333333300000033333333333333330    
000000000000000000000000000000000000000000000000000000000000000