3333333333333333333333333333333333333333333333333333333333333333333333333333333333333333333333333333333333333
3333333333333333333333333333333333333333333333333333333333333333333333333333333333333333333333333333333333333
3333333333333333333333333333333333333333333333333333333333333333333333333333333333333333333333333333333333333
3333333333333333333333333333333333333333333333333333333333333333333333333333333333333333333333333333333333333
3333333333333333333333333333333333333333333333333333333333333333333333333333333333333333333333333333333333333
3333333333333333333333333333333333333333333333333333333333333333333333333333333333333333333333333333333333333
3333333333333333333333333333333333333333333333333333333333333333333333333333333333333333333333333333333333333
3333333333333333333333333333333333333333333333333330003333333333333333333333333333333333333333333333333333333
3333333333333333333333333333333333333333333333333333333333003333333333333333333333333333333333333333333333333
3333333333333333333333333333333333333333333333333333333333333333000333333333333333333333333333333333333333333
3333333333333333333333333333333333333333333330000333333333333333333333333333333333333333333333333333333333333
3333333333333333333333333333333333333333333333333330000000333333333300000000000333333333333333333333333333333
3333333333333333333333333333333333333333333333333333333333333333333333333333333333333333333333333333333333333
3333333333333333333333333333333333333333333333333333333333300033333333333333333330003333333333333333333333330
3333333333333333333333333333333333333333333333333333333300333333333333333333333333333333333333333333333330330
3333333333333333333333333333333333333333333333333333003333333333333333333333333333333330003333333333333300320
3333333333333333333333333333333333333333333333330003333333333333333333333333333333333333333330003333333000000
3333333333333333333333333333333333333333333333333333333333333333333333333333333333333333333333333333330000000
3333333333333333333300333333333303333333000000333333333333333333333333333333333333333333333333333333300000000
3333333000333333333300333333333303333333000000333333333333333333333333333333333333333333333333333333000000000    
0000000000110110110000000000000000000000000000000011111111111111111111111111111111111111111111000000000000000