3333333333333333333333333333333333333333333333
3333333333333333333333333333333333333333333333
3333333333333333333333333333333333333333333333
3333333333333333333333333333333333333333333333
3333333333333333333333333333333333333333333333
3333333333333333333333333333333333333333333333
3333333333333333333333333333333333333333333333
3333333333333333333333333333333333333333333333
3333333333333333333333333333333333333333333333
3333333333333333333333333333333333333333333333
3333333333333333333333333333333333333333333333
3333333333333333333333333333333333333333333333
3333333333333333333333333333333333333333333333
3333333333333333333333333333333333333333333333
3333333333333333333333333333333333333333333333
3333333333333333333333333333333333333333333333
3333333333333333333333333333333333333333333333
3333333333333333333333333333333333333333333333
3333333333333333333300333333333303333333000000
3333333000333333333300333333333303333333000000    
0000000000000000000000000000000000000000000000